X X X X X X X X X X X X X X X X X X X X X X X X X X X X
X X X X X X X X X X X X X X X X X X X X X X X X X X X X
X X X X X X X X X X X X X X X X X X X X X X X X X X X X
1 1 1 1 1 1 1 7 8 1 1 1 1 1 1 1 1 1 1 7 8 1 1 1 1 1 1 1
n - - - - - n 3 3 + . . . M . . . . + 3 3 n - - - - - n
1 1 1 1 1 6 | 3 3 . 2 3 3 3 3 3 3 2 . 3 3 | 6 1 1 1 1 1
0 1 1 1 1 6 | 2 2 . 2 3 3 9 9 3 3 2 . 2 2 | 6 1 1 1 1 0
1 P . . I . + . . + . . + 3 3 + . . + . . + . . S . P 1
1 . 2 3 3 3 3 3 2 . 2 2 . 3 3 . 2 2 . 2 3 3 3 3 3 2 . 1
1 . 3 9 3 3 3 3 2 . 3 3 . 3 3 . 3 3 . 2 3 3 3 3 9 3 . 1
1 T 3 3 + . T . . + 3 3 . 2 2 . 3 3 + . . . . + 3 3 . 1
1 . 3 3 . 2 3 3 2 | 3 3 + . . + 3 3 | 2 3 3 2 . 3 3 S 1
1 . 2 2 . 2 3 9 3 | 3 9 3 3 3 3 9 3 | 3 9 3 2 . 2 2 . 1
1 + . . + . + 3 3 | 2 3 3 3 3 3 3 2 | 3 3 + . + . T + 1
0 1 1 1 1 6 . 3 3 n - - - - - - - - n 3 3 . 6 1 1 1 1 0
0 1 1 1 1 6 . 3 3 | 4 5 5 = = 5 5 4 | 3 3 . 6 1 1 1 1 0
1 + . . I . + 3 3 | 5 X X X X X X 5 | 3 3 + . . . . + 1
1 . 2 3 3 2 . 2 2 | 5 X X X X X X 5 | 2 2 . 2 3 3 2 . 1
1 . 2 3 9 3 + - - n 5 X X X X X X 5 n - - + 3 9 3 2 . 1
1 + . + 3 3 . 2 2 | 4 5 5 5 5 5 5 4 | 2 2 . 3 3 + . + 1
0 1 6 . 3 3 . 3 3 n - n - - - - n - n 3 3 . 3 3 . 6 1 0
X X 1 S 3 3 . 3 9 3 2 | 2 3 3 2 | 2 3 9 3 . 3 3 . 1 X X
X X 1 . 2 2 . 2 3 3 2 | 3 X X 3 | 2 3 3 2 . 2 2 . 1 X X
X X 1 + . . + . . M . + 3 X X 3 + . . M . + . . + 1 X X
X X 1 . 2 3 3 3 3 3 2 . 3 X X 3 . 2 3 3 3 3 3 2 . 1 X X
1 1 6 . 2 3 3 9 9 3 2 . 2 3 3 2 . 2 3 9 9 3 3 2 . 6 1 1
n - - + . . + 3 3 + . + - - - - + . + 3 3 + . . + - - n
1 1 6 . 2 2 . 3 3 . 2 3 3 3 3 3 3 2 . 3 3 . 2 2 . 6 1 1
0 1 6 . 3 3 . 2 2 . 2 3 3 9 9 3 3 2 . 2 2 . 3 3 . 6 1 0
1 P . + 3 3 + . . + . . + 3 3 + . . + . . + 3 3 + . P 1
1 . 2 3 9 3 . 2 3 3 3 2 . 3 3 . 2 3 3 3 2 I 3 9 3 2 . 1
1 . 2 3 3 2 . 2 3 3 3 2 . 2 2 . 2 3 3 3 2 . 2 3 3 2 . 1
1 + . T . . + . . S . . + . . + . . . . . + . . . . + 1
0 1 1 1 1 1 1 1 1 1 1 1 1 1 1 1 1 1 1 1 1 1 1 1 1 1 1 0
X X X X X X X X X X X X X X X X X X X X X X X X X X X X
X X X X X X X X X X X X X X X X X X X X X X X X X X X X
